1 0 0
1 1
##########
#    *   #
#        #
#       *#
#        #
#     *  #
#        #
#        #
#       E#
##########
